GGGBTTBGGGTBGGWWWWWWWWWWWWWWWWWWWGGBBGTGGBTTGBGGBB
GGBGGTBGGGGBBGGGWWWWWWWWWWWWWWGBRGGGBBTBGGGGGTTBGG
GGGGGGGTTGGGGGGGGGGWWWWWWWWWWWWGGGGGGTGRGGGGGGGGGG
GGGGGGTKGBGGGGGGGWWGGGGWWWGGGWWGGGGTTKBGGBGGGGGGGG
GGGGTTTGGGGGGWWWWWGGGGGGGGGGGGGWWGGGGGTTBGGGGGGGGG
GGGTTTGGRGGGGWGGGGGGGGGGGGGGGGGGWWWGGGGTTTGGGGGGGG
GGGTGGGGGGGGGWGGGGGGGGGGGGGGGGGGGGWWWGGGBBGGGGGGGG
GGGGGGBGGGGGWWGGGGGGGGTTTBGGGGGGGGGGWWGGGGGGGGGGGG
GGGGGGGBGGGWWGGGGGGGGGGTKBTGGGGGTGGGWWGGGGGGGGGGGG
GGGBBGGWGGWWGGGGGGGGGTTGRRGGGGGGGGGGWGGGGGGGGGGGGG
GGGGGGGWWWWGGGGGGGGGGGGRGGGGGGGGGGGGWWWGGWGGGGGGBT
GGGBGGGGGGWGGGGGTBGGGGGGGGGGGGGGGGGGGWWGWWGGGGBGGT
GGGGGGGGGGWGGGGBGGGGGGGGGGGGGGTTGGGGGGWWGGGGGGGTTT
GGGGGGGGGGWGGGGGGGGGGRRWGGGGGGGGGGGGGWWGGBGBBTTTTT
GGGGGGGGGGWGGGGGGGGGGGWWGGGGGGGGGGGGWWGGGGGRBTTTTT
GGGGTBTGGGWGGGGGGBGGGGGGGGGGGGWGGGGGWGGGGBGGGTTTTT
GGGGGTGGGGWWGGGGGGRGGGGGGGGGGRGGGGWGWGGGGGBBTTTTTT
GGGGTGGGGGGWWGGGGGGGGGGGGGGGGGGGGGGWWGGBGGGBTTTTTT
GGGGGGGGGGGGWGGGGGGGGGGGBGGGGGGGGGGWGGGGGGGGBGTTTT
GGGGGGGGGGGGWWGGGGGGBGGGTTRGGGGGGGGWGGGGGBGGGTTTTT
GGGGTTTGGGGGGWGGGGGGGGGTBTTGGGGWWWWWGGGGGGGGGGTTTT
GGGTGTGTGGGGGWGGGGGGGGGGTTGGGGGGGWGWWWGGGGGGGGGGTT
GGGTTTTTTGGGGWGGGGGGGGGGGTBBGGGGGGGGGWGGGGGGGGGGGG
GGGTBTGGBGGGGWWWWWGGGGGGGGGGGGGGGGGGGWGGGGGGGGGGGG
GGGBGGGGGGGGGGGGGWWWGGGGGBGGGGGGGGGGWWGGGGGGGGGGGG
TTGGGGGGGGGGGBGGGGWGGGGGGGGGGRGGGGGGWGGGGGGGGGGGGG
TTGGGGGGGGGGBGGGWWWGGGGBGGGGGGGGGGGGWWGGGGGGGGGGGG
tTTGGGGGGGGGGBGWWGGGGGBBGGGGGGGGGGGGGWGGGGGGGGGGGG
TTTGGGGGGGGGGWWWGGGGGGGGGGGGGGGGGGGGGWGGGGGGGTGGGG
TTTTGGGGGGGGWWGGGGGRGGGGGGGGGGGGGGGGGWWGGGGGBBTTGG
ttTTGGGGGGGGWGGGGGGGGGGGGGGtGGGGGGGGGGWGGGGGGGGTGG
tTTGGGGGGGGGWWGGGGGGGtGGGGGGGGGGGGGGGGWGGGGGGGGGGG
TTGGGGGGGGGGGWGWGGGGGGGGGGGGGGGGGGGGGWGGGGGGGGGGGG
TGGGGGGRGGGGGWWGGTBGGGGGGGGGGRGGGGGGWWGGGGGGGGGGTT
GGGGGGGGRGGGGGWGGTtBGGGRGGTTTTGGGGGGWGGGGGGGGGGTTT
GGGGGGGGGGGGBGWGTTtTBTTGGGGTttTGGWWWWGGGGGBGGGGTtt
GGGGGGGGGTGGGGWGGTTBBTtTGGGGBtTGGGGWGGGGGGGGGGGGTt
GGGGGGGGTTTGGGWGGGTGGGttGGGGBTGGGGGGWGGGGGGGGGGGGT
GGGGGGGGTTTBGWWGGTTGGGGGGGGtTTGRGGGGWGGGGGGGGGGGGT
GGGGGGGGTGGBGGWGBtGRGGGGGGGTTGBRGGGGWWGGGGGGGGGGGG
GGGGGGGGGGGGGGWGBBBGGGGGGGGBGGGGGGGWWGGGGGGGRGGGGG
GGGBGGGGBBGGGGWGGGGGGGGGGGGGGGGGWWWWGGGGGGGGGGGGGG
GGGGGGGGRGGGBGWWGGGGGGGWWWWGGGGWWGGBGGGGGGGGGGGGGG
GGGBGGGGGGGGGGGWWWGGGGWGGWWWWWWWGGGBTGGGGGRRGGGGGG
GGGGGGTGGGGBGGGGWWWWWWGGGGGGWWGWWGGBTTTGGGGGGGGGGG
GGGTTTTTGGGGGGGGGGGWGGGGPGGGGGGWWGGGGTRGGGGGGGBGGG
GTTTGTTTGGGGBGGGGGGWGGGGGGGGGGGGWWGGGGTGGGGGGGGGGB
TTTGGBTTGGGGGGGGGGWGGTBGSGGBGGGGWWGGGGGGGGGGGGGGBB
TTTTTTGGGGBGGGGGGWGGGGTGGGGGTTGGWWWWGGGGGGGGGBGGTT
TTTTTTTTTTGGGGGGGWWGGTGGGGGGGGGGGWWWWWGGGGGTTBTTTT