TTBBGGGGGTGTTttTTBGGTTGGBGGGTTTTTTTTTTTTGGGGGGGGGB
TTBGGGBGGBGTGTtTTGGGGGBGGGGGTTTTTTTTTTGBGGGGGGGGGB
TGGGGGGGGGBGGTTTBGGTTGGGGGGGGTTTTTTTTTGGGGGGGGGGBG
TGGGBGGGBGGGGGBBGGGGTGGGBBGGGTTTTTTTTGBGGGGGGGGGTG
BBGGGGGGGGGGGGGGGBGGBTGGGGGGGGTGTTTTTGGGGGBBGGGGTB
TGGGGGGGGRGGGTTGGGGGBGGGGGGBGGGBTTGBBGGGGGRBGGGGGG
TGGGGGRGGGGGGGGGGGGGGGGGGBGGGGGGBBGRBGGGGGGGGGGGGT
GGGGGGRGGGGBBGBGGGGGGGGGRGGGGGGGGBGGGGGGGGGGGGGGGT
GGGGGGGGGGBBBGGGGGGGGGGGRRGGGGBGGGBGBGWWGGGBTGBGGB
GGGGGGGGGGGRGGGGGGGGGGGGGGGGGGGGBGGGGGWGGGGBTBGGGG
GGGGGGGGGGGGGGGGGGGGGGGGGGBBBGGGBGGGGWGGGGGGTTGRBG
GGGTRTGGGGGGGGGGGGWWWGGGGGGGGBGGGGGGWWWWGGGGGTBGTT
WGGGTTGGGGWGGGGGWWGGWWWWGWWWWGGGGGGWWGWWGWWGGGKTBG
WGGGGTTGGWWWWGWWWGBGGGGWWWGGWGGGWWWWGGGWWWWWGGTGBB
WWGGGBBBWWGGGWWGGGGWRGGGGGGGWWWWWGGGGGGGGGGWGGTGGB
WWGGGGGGWGGGGGWGGGGGGBGGGGGGGWGGGWGGGGGGGGGWWGGGGG
WWWWGGGGWGGGGGWGGGGRRRGRGGGGWWGGGGGGGGGGGGGGWGGGGG
GWWWWWGWWGGGGGGGGGRGTTGGGGGGGWGGGGGGGGGGGTGGWWGGRW
GGGGWWWWGGRRGGGGGGGBBGGGGGGGGWGGGGGGGTGGGGGGGWGGBW
GGGGGGWGGGBGGTTGGGGGGGGGGGGGGGGGGGWWGTGGGGGGGGWWGW
GTGGGWWGGGGTTttTRGGGGGGGRGGGGGGGGRGGGGGGGGGGGGWWWW
GTGGGWWGGGTTBBtTGGGTTGGGGGGGGGGGGGGRGGGGGGGGGGGWWW
GGBGGGWGGBTtGBTTGGBtBGGGGGGBGGGGGGGGRRGGGGGGGGGWWW
GGGGGGWWGGGBBGGTGGGBBGGGGGGBGTRGGGGGGGGGGTGGGGGWWW
GGGGGGWWGGGGGGGRGBGGGGGGGBGTTTTGWGGGGGGGRBBGGGWWWW
GGSGPGGWGGBGTGGGTGGGGGGGGGGGTBTBWGGGGGGGRKTGGGWWWW
GGGGGGGWGGGBtTGRGGGGGGBBGGGGGTGGGGGWWGGRGTTGGGWWWW
GTBGGGWGGGGTttTGGGGGGGBGGGGGGGGRGGGWRGTKTGTGGGGWWW
TGTGGWGGGGGTTTTGGGtGGGGGGGGBGGGGGGGGRGBBTGGGGGGWWW
GGGGGWGGGGGGBBBGGGGGGGGGGGGGGTBGGGGGGGTTGGGGGGGWWW
GGGWWWGGGGRGGBTBGGGGRGGGGWGGGGGGGGGGGGGGGGGGGGGWWW
WGWGGWGGGBGTTTttBGGGGGGWWWGGGGGGGRGGGGGGGGBGGGWGWW
WWGGGWWGGBtTGTTTTGGGGGGWGWWGGGTGGGBGGGBGGGGGGWWGWW
GGGGGWWGGBBGGGTGGGGGGGWWGGWGGTTTGGGGGGTGGGTGGWGGWW
GGGGGGWWGGGGGGGGGWGGGWWGGGWGGGGGGBBGGBGGGBBGGWGGGW
GGGGGGGWWWWWWWWWWGGGGWGGGGWGGTGGGGGGGGGGGGGGGWGGGW
GGGGGGGGGGGWGGGGWWWGWWBGBGWWWWWGGGGGGGGGGGWWWWGGGG
GGGBGGGBGGGGGGBGGGWWWGGBGGGGGGWWWGGGBBGGGWWGGGGGBG
GGGGGBGGGGBBGGGGGGGGGGGGGGGGGGGGWWGGGGGGWWGGGGGGBB
GBGGGGGGGGGTTGGGGGGGGBBGGGGGGGGGGWWWWWWWWGGGGGGGGT
TGGGGGGGBGGTTTGGGGGGGTGGGGGGGGGGGGGGGGGWGGGGGGBGGG
TGGGGGGRBGTTTGGRGGGGGGRGGGBTGGGGGGGGGGGWGGGGRGGTGG
TGTTTGGGGGGGBGGGRGGGGGGGGGGTTGGGGGGGGGGWWBGGGGKTGG
TGTTTTGGGGGGGGGGGGTBGGGGGGGTGTGGGGTGGGGGGGBGGTTGBB
TTBTTGGGGGGGGGGGGGGGBGGGGGTTTTGGGTBGGGGGGGGGTTGGTT
TTGGTGGGGGGGGGGGGTGTTTGGGGBTGTGGTGTGGGGGBGGGTTGGGT
TTGTTGBGBGGGGGGTGBGTTBBGGBTTTGGGGGGGGGBGBGGTTGGGGB
TTTTGGGGGGGGGGBGBGTTTTTTGTGGGGGGGGGGGBGGGGGGGGGGBG
TTTTGGGGGGGGGGGTGTTtTTTTTGBGGGGGGGGGGGGGGGTGGGGGGG
TTTGGGGGGGGGGGTGTTttTTtTTTTGGGGGGGBBBGBGGGGGTGGTTG