ttGTBGGGGGBRGGBRGGRRRGRRRBGGGGGGBGGTTGRG
RtTGTGGBGTGBTTGGRRGGRGGRGGGBKGGGGGTTTGRG
TBGTGGGBTTTBBBBBBGRBGRGGGGRGGGTTGTTTTTGR
TGGBTTBGTTTGGTTRGGRGRBRGGGGGGTTTGTTTTTTG
BGGBBBBGRGGTBGGTGRGBGGRGGTGGTTTTTTTTGTGG
TGGGGGGGGBGBTGBGTTTBRRTGGGGGGTTTTTTTGTGG
TTGGTTGTGBBBTGGGGTBBGRGGGGGTTTTTTTTTTGGG
RTRGTTGTTGGTGGBGTTGTRTGGGGGGTTTTTTTTTGTG
WRTTTTTTTTGGGGGGGTTGBTBGGGGGGGGTGGTTTTGG
WRTTTTTTGGGTGGGGTTGTRGGGGGGGGGTGGTTTTTGR
WTRTTTBGTTTGGRTTTTTGGGGGGGGGGGGGGGGTGGTT
WWBRGGGGTTTTGGRTGGGGGGGGGGBGGGGGGGGGGGRR
WWRTTTGGGTTGGTGTGGGGGGGGGGBGGRGGGGKGRRGR
BWTGTTTBTBBGGBGGGGGGGGGGGTGGGGGGGGGGBGRT
BWWGGTGBBBGGGGBGGGGGGTBGGGTTGTTGGGGGBGTT
BRWGGGGRGGGGGGGGGGGGTTBTGTTTTTTTGGGRGGBG
GBWGTGGGGGGGTGGGGGGTTTTGGGGGTTTTRRGGTTRT
GBWTGGGGGGTTTGGGGGGTGTTGBGGGTTTGGGTTTRTT
TBWWWGGGGGGTTGGGGGGTTTTGTGGGTTGTTBRGTTGT
TGGGGWWWGGGGGGGGGBGGGGGGGGGGTGGGTTTTTTTT
TTGGGGWGGGGGGGRBBGGGTGGTTGGGGGRRGTTTTRGt
GGGGGGWWGGGGGGGGGKGGGGTTTGGGBBGGTRGGGTTt
BGGGGGGWWBGGGGGGGBGGTTTTTTGGBBBBGGGBGTTt
GGGGGGGWWWWWGGGGGTTGTTTTTTGTGGGKGGTGGTTT
GBGSGPGGGGGBWWRGRTTGGTTTTTGGBGGTGGGTTGGR
BGTGGTGGGBGRWWWRTRGTGTTTTGTGGGBGGGGTTGRt
GBTTGGGGGBBBBWWWRRTTTTBGGTTTGGGGBGGTBTTT